1;1;2;1;1;3;2;1;
1;1;1;1;1;1;1;32570;
3;3;3;1;1;3;3;0;
3;1;1;1;1;1;1;1;
1;1;2;1;1;2;3;1;
1;1;1;1;1;1;2;1;
1;1;1;1;1;1;1;1;
1;1;1;1;1;1;1;1;
